NO ./test_maps/textures/wood.xpm
SO ./test_maps/textures/redbrick.xpm
WE ./test_maps/textures/colorstone.xpm
EA ./test_maps/textures/mossy.xpm


F 225,255,255
C 225,0,0

1111111111
101S000101
1011110101
1010100101
1010000001
1011111001
1000000001
1000000001
1000000001
1000000001
1111111111
